STONE -1 -1 -1 0 0 0
STONE 0 -1 -1 0 0 0
STONE 1 -1 -1 0 0 0
STONE -1 -1 -2 0 0 0
STONE 0 -1 -2 0 0 0
STONE 1 -1 -2 0 0 0
STONE -1 -1 -3 0 0 0
STONE 0 -1 -3 0 0 0
STONE 1 -1 -3 0 0 0
STONE -1 -1 -4 0 0 0
STONE 0 -1 -4 0 0 0
STONE 1 -1 -4 0 0 0
STONE -1 -1 -5 0 0 0
STONE 0 -1 -5 0 0 0
STONE 1 -1 -5 0 0 0
STONE 0 1 -3 0 0 0
STONE -1 0 -3 0 0 0
STONE 1 2 -3 0 0 0